#######################################################
#S                                                    #
# ### # ### ##### ### # ######### ### ##### ### ##### #
#   # #   #     #   # #         #   #     #   #     # #
# ### # ####### # # # ### ### ##### # # ######### # ###
#   # #       # # # #   #   #     # # #         # #   #
# # # # ##### # ####### # ####### ### ####### # # #####
# # # #     # #       # #       #   #       # # #     #
# # # ####### ########### # ####### ### ### ######### #
# # #       #           # #       #   #   #         # #
# ### ### # # ##### ################### # ### ####### #
#   #   # # #     #                   # #   #       # #
# # # # # # ### ### # ####### # # # ### ### ####### # #
# # # # # #   #   # #       # # # #   #   #       # # #
# ##### # ####### ######### # # ########### # ##### # #
#     # #       #         # # #           # #     # # #
# # # # ##### # # # ### # # # # # ########### # # # ###
# # # #     # # # #   # # # # # #           # # # #   #
# ##### ####### # # # # ### # # ### # # ##### # # # # #
#     #       # # # # #   # # #   # # #     # # # # # #
# ####### # # ### # ######### ### # ####### # ### # # #
#       # # #   # #         #   # #       # #   # # # #
# ##### # # ##### ####### # ### ##### # # #############
#     # # #     #       # #   #     # # #             #
# # ##### # ### # # ####### ####### ### ### # ####### #
# #     # #   # # #       #       #   #   # #       # #
# ### # # # # ##### # ### ### # ### ############# #####
#   # # # # #     # #   #   # #   #             #     #
# ### ############# # # # ############# # ### # # ### #
#   #             # # # #             # #   # # #   # #
# ######### # ##### ### # # ### ######### ########### #
#         # #     #   # # #   #         #           # #
# ### # # # ### ### ##### # ####### ##### ### # ### # #
#   # # # #   #   #     # #       #     #   # #   # # #
# ### ### ### ### ### # ##### ### # ### # ##### ### # #
#   #   #   #   #   # #     #   # #   # #     #   # # #
# # # # ######### # ########### ### ### # # # ### ### #
# # # #         # #           #   #   # # # #   #   # #
# # ### # ##### # # ############# # # ### ### ### ### #
# #   # #     # # #             # # #   #   #   #   # #
# # # # # ##### ####### # ### ##### ### # ##### # # ###
# # # # #     #       # #   #     #   # #     # # #   #
# # ### # # # ##### # # ##### ### # # ##### ### #######
# #   # # # #     # # #     #   # # #     #   #      E#
#######################################################