#####################################################################################################################################################################
#S                                                                                                                                                                  #
# # ##### ### ##### # # # ### # ####### # ##### ####### # # # # ######### # # ### # # ### # ### # # ### # # # ########### # ### ####### ### ### # # # # #############
# #     #   #     # # # #   # #       # #     #       # # # # #         # # #   # # #   # #   # # #   # # # #           # #   #       #   #   # # # # #             #
# ### ##### # ### ####### ######### # ### # # ############# # ##### ### ##### ### # # # ### # # ### # ### # # ########### ### # # # ### # # # # # # # # # # ### # ###
#   #     # #   #       #         # #   # # #             # #     #   #     #   # # # #   # # #   # #   # # #           #   # # # #   # # # # # # # # # # #   # #   #
# ### ####### ### ########### ### ### # # ##### ##### # # ##### # ##### # # ############# ### ### ### ### # ### # ############### ### ############### # ##### ##### #
#   #       #   #           #   #   # # #     #     # # #     # #     # # #             #   #   #   #   # #   # #               #   #               # #     #     # #
# ##### # ##### # ### # # # # ### # ##### ####### # # # ### ### # # ##### # ### # # ### ### # # # # # # # # # # # # # # ############# # # # ##### # # ### ### ### # #
#     # #     # #   # # # # #   # #     #       # # # #   #   # # #     # #   # # #   #   # # # # # # # # # # # # # # #             # # # #     # # #   #   #   # # #
# ####### ### # ######### # # # ##### ##### # # # ### ### ####### ### ### ############# ##### ### # # # # # ### # ######### # # ### # # ##### ####### ###############
#       #   # #         # # # #     #     # # # #   #   #       #   #   #             #     #   # # # # # #   # #         # # #   # # #     #       #               #
# # ### # ####### # # # ### ### ##### ### # ### # ##### # ### ### ### ##### ######### # # ### # # # ####### ##### ########### # # ##### ### ##### ### # ### # # #####
# #   # #       # # # #   #   #     #   # #   # #     # #   #   #   #     #         # # #   # # # #       #     #           # # #     #   #     #   # #   # # #     #
# # ### ####### ### # ##### # # ##### ### # ### ##### ######### ### # ### ##### # ### # ##### ### ####### ##### ##### # ##### # # # ### # # ### # # ### # # ### # ###
# #   #       #   # #     # # #     #   # #   #     #         #   # #   #     # #   # #     #   #       #     #     # #     # # # #   # # #   # # #   # # #   # #   #
# ####### ##### # # # ### # ### ####### ### ### # ##### ####### ##### # # # ####### ### ### ##### # ### ##### ######### # # ### # # # # ####### ### ### # ### ### ###
#       #     # # # #   # #   #       #   #   # #     #       #     # # # #       #   #   #     # #   #     #         # # #   # # # # #       #   #   # #   #   #   #
# ### # # ### # # ############# # ####### ##################### # ######### ### # ### # ######### # # # # ### # ### ##### ### ########### ### ### ### ### ### # # ###
#   # # #   # # #             # #       #                     # #         #   # #   # #         # # # # #   # #   #     #   #           #   #   #   #   #   # # #   #
# # # # ### # ##### ### ########### # # # # ######### ### ### # # # ##### # # # # # # ### # # # # # ##### ##### # ##### ##### # ########### ### # # # # ### # ##### #
# # # #   # #     #   #           # # # # #         #   #   # # # #     # # # # # # #   # # # # # #     #     # #     #     # #           #   # # # # #   # #     # #
# # ### # ### # # # # ### # # # # ####### ####### ##### ##### ### ######### # # ### ##### # ### # ### ### ######### ##### ##### ### ######### # ### # ### # ### # # #
# #   # #   # # # # #   # # # # #       #       #     #     #   #         # # #   #     # #   # #   #   #         #     #     #   #         # #   # #   # #   # # # #
# ### ##### ### ### # ##### ##### # # # ### # # # # # ##### # # # ### ### # # ####### # # # ### # # # # # # ##### # # ##### # ##### # ##### ##### # ### # # ### # ###
#   #     #   #   # #     #     # # # #   # # # # # #     # # # #   #   # # #       # # # #   # # # # # # #     # # #     # #     # #     #     # #   # # #   # #   #
# ##### # ####### ### ##### ### ### # # ##### # ##### ### # ### ######### ####### # ##### ### # ####### ########### ##### # # # # # ### ### ####### # ### # # # # ###
#     # #       #   #     #   #   # # #     # #     #   # #   #         #       # #     #   # #       #           #     # # # # # #   #   #       # #   # # # # #   #
# ########### ##### ### # # # ##### # # # ############# # ### # # ##### ### # # ### # # # ##### ##### ### ### # ### # # # ##### # ##### ######### # # ### ### ### # #
#           #     #   # # # #     # # # #             # #   # # #     #   # # #   # # # #     #     #   #   # #   # # # #     # #     #         # # #   #   #   # # #
# # ### # ##### ##### # ### ##### # ####### # ##### ######### ### ####### ### ############# ####### ### ### ### ### ### # # # ### # ### # # # # # # # # ####### #####
# #   # #     #     # #   #     # #       # #     #         #   #       #   #             #       #   #   #   #   #   # # # #   # #   # # # # # # # # #       #     #
# # ### # # ##### ### # ####### # ### ### # # # # ####### # # # ### # ### ### # ######### ######### # ####### # ####### ##### # ### ### ### ### # ######### #########
# #   # # #     #   # #       # #   #   # # # # #       # # # #   # #   #   # #         #         # #       # #       #     # #   #   #   #   # #         #         #
# # ##### ####### # ####### ####### ### ### # ### # # # # ####### ### ############### ### # # # ############# # # ### # ### ##### ##### # # # # # # # ####### ##### #
# #     #       # #       #       #   #   # #   # # # # #       #   #               #   # # # #             # # #   # #   #     #     # # # # # # # #       #     # #
# # ##### ##### ##### # ##### # # ####### ####### # # ### ### ##### ### ### # # # # # ### ####### # # # ### # # # ####### # # ### # ### ### # # # # ##### # ### ### #
# #     #     #     # #     # # #       #       # # #   #   #     #   #   # # # # # #   #       # # # #   # # # #       # # #   # #   #   # # # # #     # #   #   # #
# ### ##### ### ##### ### # ### # ##### # ### ### # # ### # # # # # # # ####### ### ##### # # ####### # # ### ### ### ############# ### # ####### ### ### ####### ###
#   #     #   #     #   # #   # #     # #   #   # # #   # # # # # # # #       #   #     # # #       # # #   #   #   #             #   # #       #   #   #       #   #
# ####### # # ### ### ##### ######### ### # ### ### # ##### # ######### ### # ### # # ### # # ##### # # # # ####### ##### # ##### # ################# ########### ###
#       # # #   #   #     #         #   # #   #   # #     # #         #   # #   # # #   # # #     # # # # #       #     # #     # #                 #           #   #
# # # # ##### # ### # ######### ### # ### # ##### ### # # # # # # # # # # # # # # # # ### ### ####### ####### ### # # ####### ### # ##### ### # ############### #####
# # # #     # #   # #         #   # #   # #     #   # # # # # # # # # # # # # # # # #   #   #       #       #   # # #       #   # #     #   # #               #    E#
#####################################################################################################################################################################