###########################################################################
#S                                                                        #
# # ##### # # ### # ### ### # ### ### ##### # ### ### # # # # ####### ### #
# #     # # #   # #   #   # #   #   #     # #   #   # # # # #       #   # #
# ######### # ##### ##### # # # # # # # ### ### # ##################### # #
#         # #     #     # # # # # # # #   #   # #                     # # #
# ##### ### # # ### # # ### # # # # # # # # ### ##### # ### # ##### ### ###
#     #   # # #   # # #   # # # # # # # # #   #     # #   # #     #   #   #
# ### ##### # # # ######### # # # ### ##### # ### # # ##### # # # # # #####
#   #     # # # #         # # # #   #     # #   # # #     # # # # # #     #
# # # # # # # # # ########### ### # ####### ##### ### ### # ### # # # # # #
# # # # # # # # #           #   # #       #     #   #   # #   # # # # # # #
# # # ####### ##### ####### # # ### # ### # # ##### # # ######### # # ### #
# # #       #     #       # # #   # #   # # #     # # #         # # #   # #
# ### ########### # # # # ####### ######### # # # ### ### ### # ##### ### #
#   #           # # # # #       #         # # # #   #   #   # #     #   # #
# # ##### # ####### ### ### # ### ##### # ##### # ##### # # # ### # ##### #
# #     # #       #   #   # #   #     # #     # #     # # # #   # #     # #
# # ### # # ##### ####### ####### ##### # ##### ######### # ####### ### ###
# #   # # #     #       #       #     # #     #         # #       #   #   #
# # ##### # # ### # # # ### # # ####### # ##### ####### ##### # # ### #####
# #     # # #   # # # #   # # #       # #     #       #     # # #   #     #
# ##### ####### ##### ##### # # # ##### # # # ### # ### # ### # # # # # ###
#     #       #     #     # # # #     # # # #   # #   # #   # # # # # #   #
# # ######### ######### # ##### # # ######### ### # ####### # # ### ##### #
# #         #         # #     # # #         #   # #       # # #   #     # #
# # # ### ### ### ####### ####### # # ##### # ##### ####### # # ### # ### #
# # #   #   #   #       #       # # #     # #     #       # # #   # #   # #
# # ### ##### ### # ##### ### ### # # ##### ### ### # ### ##### # ### # ###
# #   #     #   # #     #   #   # # #     #   #   # #   #     # #   # #   #
# # # # # ### # ### ### # # # # # ### ##### # ##### ##### ##### ####### ###
# # # # #   # #   #   # # # # # #   #     # #     #     #     #       #   #
# ##### # # ######### # # # # # ##### ### ##### # # # ########### ##### ###
#     # # #         # # # # # #     #   #     # # # #           #     #   #
# # ### ##### ### # # ##### # ##### # # ####### ##### ### ### # # # # # ###
# #   #     #   # # #     # #     # # #       #     #   #   # # # # # #   #
# # ####### # ### ########### # # ##### # ######### # ##### ### ##### # ###
# #       # #   #           # # #     # #         # #     #   #     # #   #
# ####### ### # # # # ### # ##### # # ### # # # # ### ### # ### # # # ### #
#       #   # # # # #   # #     # # #   # # # # #   #   # #   # # # #   # #
# # ### ##### ### # ### ##### # ##### ### # ################# # # #########
# #   #     #   # #   #     # #     #   # #                 # # #         #
# # ### # # ### ##### # ####### ##### # ### # ######### # # # #############
# #   # # #   #     # #       #     # #   # #         # # # #            E#
###########################################################################