###########
# S   #  ##
#  ## #  ##
# #  ##  ##
# # ##   ##
#   #   # #
# # #  #  #
#      #E##
###########