############################
# ##       #### S ## ## ####
#    #     #        #   ## #
# ##    # ## ###### # ##   #
#  ###  #  #    ##   # #  ##
# #  #  #  #  ## # # # # ###
# # # ###  #  ##  #  #  # ##
#             #      #     #
############   #    #####  #
#E           ##   ######  ##
############################